non-aja YNOSO.DAT for ZLOGCG.EXE
kCSߋ	kCSߋ
kCS	kCS
kCSʒ	kCSʒ
kC݌Sݒ	kC݌Sݒ
kC݌Sl	kC݌Sl
kCԑSÕʒ	kCԑSÕʒ
kCԑSy	kCԑSy
kCԑS	kCԑS
kCcS(u)ɒ	kCcS(u)ɒ
kCcS(u)m	kCcS(u)m
kCcS(u)^둺	kCcS(u)^둺
kCcS(u)s	kCcS(u)s
kCcS(u)Εʒ	kCcS(u)Εʒ
kCcS(u)jZR	kCcS(u)jZR
kCcS(_U)LY	kCcS(_U)LY
kCcS(_U)Β	kCcS(_U)Β
kCΎSVÑ	kCΎSVÑ
kCΎSʒ	kCΎSʒ
kCJSz	kCJSz
kCDys	kCDys
Dys	Dys
Dysk	Dysk
Dys	Dys
Dys΋	Dys΋
DysL	DysL
Dys	Dys
Dys	Dys
Dysʋ	Dysʋ
Dys	Dys
kCS	kCS
kCSa	kCSa
Dysc	Dysc
kCLSs˒	kCLSs˒
kCY͌SY͒	kCY͌SY͒
kCJS(m)ʒ	kCJS(m)ʒ
kCJS(m)w	kCJS(m)w
kCJS(m)J	kCJS(m)J
kCJS(m)c	kCJS(m)c
kCJS(m)k	kCJS(m)k
kC}KS}K	kC}KS}K
kC}KSڕʒ	kC}KSڕʒ
kC}KSlڕʒ	kC}KSlڕʒ
kCKSK	kCKSK
kC͐SXʑ	kC͐SXʑ
kC͐SD	kC͐SD
kC͐S莺	kC͐S莺
kC͓SX	kC͓SX
kC͓Smy	kC͓Smy
kC͓Sǒ	kC͓Sǒ
kC͓Smy	kC͓Smy
kCs	kCs
kCˌSYP	kCˌSYP
kCˌSV\Ð쒬	kCˌSV\Ð쒬
kCˌS`	kCˌS`
kCS،Ó	kCS،Ó
kCSm	kCSm
kCS(\)	kCS(\)
kCS(\)V	kCS(\)V
kCS()쒬	kCS()쒬
kCS()	kCS()
kCS()鐲	kCS()鐲
kCS()	kCS()
kCS()z	kCS()z
kCS()ʒ	kCS()ʒ
kCS()쒬	kCS()쒬
kCS()l	kCS()l
kCS()_y	kCS()_y
kCS()쒬	kCS()쒬
kCS()a	kCS()a
kCTcSђ	kCTcSђ
kCS	kCS
kCSX	kCSX
kCSW	kCSW
kCSq	kCSq
kCHSH	kCHSH
kCvSȒ	kCvSȒ
kCMs	kCMs
kClSl	kClSl
kCS	kCS
kCS撬	kCS撬
kCWÌSWÒ	kCWÌSWÒ
kCWÌSWÒ	kCWÌSWÒ
kCqSq	kCqSq
kCϒOSϒO	kCϒOSϒO
kCΗS	kCΗS
kCΗS	kCΗS
kCΗSΗ	kCΗSΗ
kCVSV	kCVSV
kCfSf	kCfSf
kCsS	kCsS
kCsSs	kCsSs
kCَs	kCَs
kCIS	kCIS
kC@JS	kC@JS
kCmS(m)㍻쒬	kCmS(m)㍻쒬
kCmS(m)ވ]	kCmS(m)ވ]
kCmS(m)y	kCmS(m)y
kCmS()xǖ쒬	kCmS()xǖ쒬
kCmS()xǖ쒬	kCmS()xǖ쒬
kCmS()xǖ쒬	kCmS()xǖ쒬
kCVS(G)ʒ	kCVS(G)ʒ
kCVS(G)V	kCVS(G)V
kCVS(@J)Lx	kCVS(@J)Lx
kCVS(@J)y	kCVS(@J)y
kC\SYy	kC\SYy
kCCSPq{	kCCSPq{
kCCSu˒	kCCSu˒
kCCSCԒ	kCCSCԒ
kCϑOSRʑ	kCϑOSRʑ
kCϑOSϑO	kCϑOSϑO
kCϑOSHy	kCϑOSHy
kCs	kCs
kCS()Ўq{	kCS()Ўq{
kCS()쒬	kCS()쒬
kCS()[	kCS()[
kCS(\)rc	kCS(\)rc
kCS(\)L	kCS(\)L
kCS(\){ʒ	kCS(\){ʒ
kCS(\)ʒ	kCS(\)ʒ
kCVSV	kCVSV
kCuS	kCuS
kCtSʊC	kCtSʊC
kCwRS]	kCwRS]
kCwRS򕔒	kCwRS򕔒
kCwRSm	kCwRSm
kCHs	kCHs
kCLS	kCLS
kCLSL	kCLSL
kCÉFS	kCÉFS
kCÉFS_b	kCÉFS_b
kCÕSÕ	kCÕSÕ
kCyS	kCyS
kCьSђ	kCьSђ
kCOS	kCOS
kCOSO	kCOSO
kCڗSP	kCڗSP
kCэLs	kCэLs
kCʌSy	kCʌSy
kCʌSY	kCʌSY
kCʌS	kCʌS
kCʌS㒬	kCʌS㒬
kCʌS	kCʌS
kCʌSNʒ	kCʌSNʒ
kCRzS	kCRzS
kC[SIR	kC[SIR
kC[S	kC[S
kC[SRm	kC[SRm
kCES(_U)^	kCES(_U)^
kCES(_U)	kCES(_U)
kCES(_U)ނ풬	kCES(_U)ނ풬
kCES()芥	kCES()芥
kC]sSԈ쑺	kC]sSԈ쑺
kC]sSmؒ	kC]sSmؒ
kC]sS]s	kC]sS]s
kCKSKxm	kCKSKxm
kCKSK	kCKSK
kCGS	kCGS
kC當S當	kC當S當
kCCS_	kCCS_
kCks	kCks
kCSVЂ	kCSVЂ
kCJS()y	kCJS()y
kC[s	kC[s
kC〈s	kC〈s
kCԑs	kCԑs
kCGs	kCGs
kCϏqs	kCϏqs
kCts	kCts
kCSs	kCSs
kCʎs	kCʎs
kC]ʎs	kC]ʎs
kCԕs	kCԕs
kCʎs	kCʎs
kCmʎs	kCmʎs
kCs	kCs
kCO}s	kCO}s
kCs	kCs
kCΎs	kCΎs
kCs	kCs
kCs	kCs
kC̎us	kC̎us
kC[s	kC[s
kCxǖs	kCxǖs
kCoʎs	kCoʎs
kCbs	kCbs
kCɒBs	kCɒBs
kCkLs	kCkLs
kCΎs	kCΎs
kCkls	kCkls
XkS˒	XkS˒
XkSk	XkSk
XkSӒn	XkSӒn
XkSl	XkSl
XkSZ˒	XkSZ˒
XkSZ	XkSZ
XkS点	XkS点
XkÌySߓc	XkÌySߓc
XkÌyS	XkÌyS
XkÌyS	XkÌyS
XOˌSK㒬	XOˌSK㒬
XOˌS܌˒	XOˌS܌˒
XOˌSO˒	XOˌSO˒
XOˌSV	XOˌSV
XOˌScq	XOˌScq
XOˌS암	XOˌS암
XkSԒ	XkSԒ
XkSԉY	XkSԉY
XkS䑺	XkS䑺
XkSʑ	XkSʑ
XÌySډ	XÌySډ
XÌyS˃	XÌyS˃
XÌyS[Y	XÌyS[Y
XÌySHc	XÌySHc
XÌySʒ	XÌySʒ
XÌyS	XÌyS
XÌySOl	XÌySOl
XÌyScɊّ	XÌyScɊّ
XÌyS蒬	XÌyS蒬
XÌySk	XÌySk
XXs	XXs
XOOs	XOOs
Xˎs	Xˎs
XΎs	XΎs
X܏쌴s	X܏쌴s
X\acs	X\acs
XOs	XOs
Xނs	Xނs
Xs	Xs
Xs	Xs
茧_S蒬	茧_S蒬
茧S蒬	茧S蒬
茧S	茧S
茧SΒ	茧SΒ
茧S	茧S
茧ɌSƒ	茧ɌSƒ
茧ˌSc	茧ˌSc
茧ˌSyĒ	茧ˌSyĒ
茧ˌSˑ	茧ˌSˑ
茧ˌSm쒬	茧ˌSm쒬
茧CSZc	茧CSZc
茧ɌSc씨	茧ɌSc씨
茧ɌS㑺	茧ɌS㑺
茧ɌS	茧ɌS
茧ɌSRc	茧ɌSRc
茧gSВ	茧gSВ
茧gSg	茧gSg
茧ֈS	茧ֈS
茧s	茧s
茧ˌS˒	茧ˌS˒
茧aSa꒬	茧aSa꒬
茧Ύs	茧Ύs
茧{Îs	茧{Îs
茧֎s	茧֎s
茧Dns	茧Dns
茧Ԋs	茧Ԋs
茧ks	茧ks
茧vs	茧vs
茧s	茧s
茧Ocs	茧Ocs
茧ˎs	茧ˎs
茧s	茧s
茧Bs	茧Bs
茧s	茧s
HcYS	HcYS
HcYSH㒬	HcYSH㒬
HcpS⒬	HcpS⒬
HckHcS㏬m	HckHcS㏬m
HckS	HckS
HcHcS쒬	HcHcS쒬
HcHcSY	HcHcSY
HcHcS劃	HcHcS劃
HcHcS܏ڒ	HcHcS܏ڒ
HcR{S	HcR{S
HcR{SO풬	HcR{SO풬
HcR{S	HcR{S
HcHcs	HcHcs
Hc\s	Hc\s
Hcَs	Hcَs
Hcs	Hcs
Hcjs	Hcjs
Hcs	Hcs
Hcps	Hcps
HcR{s	HcR{s
Hcs	Hcs
Hcs	Hcs
HckHcs	HckHcs
Hcɂَs	Hcɂَs
Hcks	Hcks
R`OCSV	R`OCSV
R`kRSΓc	R`kRSΓc
R`uSіL	R`uSіL
R`uS	R`uS
R`uS钬	R`uS钬
R`RS͖k	R`RS͖k
R`RS	R`RS
R`RS]	R`RS]
R`RS쒬	R`RS쒬
R`uS쐼	R`uS쐼
R`uS	R`uS
R`cSO쒬	R`cSO쒬
R`cS	R`cS
R`RSR	R`RSR
R`RSRӒ	R`RSRӒ
R`R`s	R`R`s
R`ŏSR	R`ŏSR
R`ŏS쑺	R`ŏS쑺
R`ŏS呠	R`ŏS呠
R`ŏSˑ	R`ŏSˑ
R`ŏSM`	R`ŏSM`
R`ŏS^쒬	R`ŏS^쒬
R`ŏSŏ㒬	R`ŏSŏ㒬
R`đs	R`đs
R`߉s	R`߉s
R`cs	R`cs
R`Vs	R`Vs
R`͍]s	R`͍]s
R`Rs	R`Rs
R`Rs	R`Rs
R`s	R`s
R`Vs	R`Vs
R`s	R`s
R`ԑs	R`ԑs
R`zs	R`zs
{錧ɋSېX	{錧ɋSېX
{錧S쒬	{錧S쒬
{錧cS	{錧cS
{錧cSh	{錧cSh
{錧SF	{錧SF
{錧S	{錧S
{錧S勽	{錧S勽
{錧St	{錧St
{錧Sa	{錧Sa
{錧ēcS͌	{錧ēcS͌
{錧ēcS蒬	{錧ēcS蒬
{錧ēcSēc	{錧ēcSēc
{錧ēcSc	{錧ēcSc
{錧s	{錧s
st	st
s{	s{
sы	sы
s	s
s	s
{錧cSOJ	{錧cSOJ
{錧cS	{錧cS
{錧{Sl	{錧{Sl
{錧{S	{錧{S
{錧{S{	{錧{S{
{錧{gSO	{錧{gSO
{錧jSj	{錧jSj
{錧jSR	{錧jSR
{錧Ίs	{錧Ίs
{錧}s	{錧}s
{錧Cs	{錧Cs
{錧Ύs	{錧Ύs
{錧s	{錧s
{錧pcs	{錧pcs
{錧s	{錧s
{錧s	{錧s
{錧oĎs	{錧oĎs
{錧Is	{錧Is
{錧s	{錧s
{錧s	{錧s
{錧xJs	{錧xJs
BSʑ	BSʑ
ΐS쒬	ΐS쒬
ΐSΐ쒬	ΐSΐ쒬
ΐSʐ쑺	ΐSʐ쑺
ΐSc	ΐSc
ΐSÓa	ΐSÓa
␣SΒ	␣SΒ
␣SVh	␣SVh
SR	SR
Sa	Sa
SO	SO
SÔ	SÔ
͏S쑺	͏S쑺
͏SÍ≺	͏SÍ≺
͏SÒ	͏SÒ
s	s
nSъڑ	nSъڑ
nSVn	nSVn
ɒBS	ɒBS
ɒBSKܒ	ɒBSKܒ
ɒBS얓	ɒBS얓
cS쒬	cS쒬
cSOt	cSOt
͌S葺	͌S葺
͌S	͌S
͌S	͌S
͌S	͌S
SL쑺	SL쑺
SIq	SIq
S	S
SՒ	SՒ
otSF	otSF
otSx	otSx
otSL쒬	otSL쒬
otSot	otSot
otS	otS
otS	otS
otSQ]	otSQ]
otSt	otSt
ÌSw}	ÌSw}
ÌS	ÌS
ÌS	ÌS
ÌSÒ	ÌSÒ
떃S֒	떃S֒
떃Sc㒬	떃Sc㒬
떃Sk	떃Sk
떃SÒ	떃SÒ
Îᏼs	Îᏼs
SRs	SRs
͎s	͎s
{s	{s
쑽s	쑽s
ns	ns
{s	{s
킫s	킫s
cs	cs
쑊ns	쑊ns
ɒBs	ɒBs
{{s	{{s
VDSY	VDSY
VDS֐쑺	VDS֐쑺
VHSH	VHSH
VkSĒ	VkSĒ
VOSo_蒬	VOSo_蒬
VSÓ쒬	VSÓ쒬
VVs	VVs
Vsk	Vsk
Vs	Vs
Vs	Vs
Vs]	Vs]
VsHt	VsHt
Vs	Vs
Vs	Vs
Vs	Vs
VSF	VSF
VS꒬	VS꒬
V싛S	V싛S
V슗Sc㒬	V슗Sc㒬
Vs	Vs
VOs	VOs
Vs	Vs
VVcs	VVcs
VJs	VJs
VΎs	VΎs
V\s	V\s
Vs	Vs
Vs	Vs
Vs	Vs
Vs	Vs
Vܐs	Vܐs
Vzs	Vzs
Vs	Vs
Vns	Vns
Vs	Vs
V싛s	V싛s
Vs	Vs
Vٓs	Vٓs
쌧ɓߌS얥֑	쌧ɓߌS얥֑
쌧ɓߌS֒	쌧ɓߌS֒
쌧ɓߌS{c	쌧ɓߌS{c
쌧ɓߌSѓ	쌧ɓߌSѓ
쌧ɓߌSC쒬	쌧ɓߌSC쒬
쌧ɓߌS쑺	쌧ɓߌS쑺
쌧㍂Sz{	쌧㍂Sz{
쌧㍂SR	쌧㍂SR
쌧㐅S쑺	쌧㐅S쑺
쌧㐅SMZ	쌧㐅SMZ
쌧㐅Sэj	쌧㐅Sэj
쌧ؑ]S㏼	쌧ؑ]S㏼
쌧ؑ]Sꑺ	쌧ؑ]Sꑺ
쌧ؑ]SK	쌧ؑ]SK
쌧ؑ]Sؑc	쌧ؑ]Sؑc
쌧ؑ]Sؑ]	쌧ؑ]Sؑ]
쌧ؑ]Sؑ]	쌧ؑ]Sؑ]
쌧k܌Src	쌧k܌Src
쌧k܌S쑺	쌧k܌S쑺
쌧k܌SJ	쌧k܌SJ
쌧k܌Sn	쌧k܌Sn
쌧kvSy	쌧kvSy
쌧kvSȒ	쌧kvSȒ
쌧kvSc	쌧kvSc
쌧ɓߌSq	쌧ɓߌSq
쌧ɓߌSؑ	쌧ɓߌSؑ
쌧ɓߌS厭	쌧ɓߌS厭
쌧ɓߌS	쌧ɓߌS
쌧ɓߌSؑ	쌧ɓߌSؑ
쌧ɓߌSH	쌧ɓߌSH
쌧ɓߌSJ	쌧ɓߌSJ
쌧ɓߌSו	쌧ɓߌSו
쌧ɓߌS쒬	쌧ɓߌS쒬
쌧ɓߌSX	쌧ɓߌSX
쌧ɓߌSV	쌧ɓߌSV
쌧ɓߌSLu	쌧ɓߌSLu
쌧ɓߌS쒬	쌧ɓߌS쒬
쌧Sؓ	쌧Sؓ
쌧S򉷐	쌧S򉷐
쌧SRm	쌧SRm
쌧s	쌧s
쌧Sh	쌧Sh
쌧zKSzK	쌧zKSzK
쌧zKS	쌧zKS
쌧zKSxm	쌧zKSxm
쌧Sؑ	쌧Sؑ
쌧Sa	쌧Sa
쌧ȌS钬	쌧ȌS钬
쌧}S	쌧}S
쌧}Sё	쌧}Sё
쌧}SR`	쌧}SR`
쌧}S⑺	쌧}S⑺
쌧}S}k	쌧}S}k
쌧썲vS㑺	쌧썲vS㑺
쌧썲vSkؑ	쌧썲vSkؑ
쌧썲vSC	쌧썲vSC
쌧썲vS쑊ؑ	쌧썲vS쑊ؑ
쌧썲vSq	쌧썲vSq
쌧썲vSv䒬	쌧썲vSv䒬
쌧{s	쌧{s
쌧cs	쌧cs
쌧Js	쌧Js
쌧ѓcs	쌧ѓcs
쌧zKs	쌧zKs
쌧{s	쌧{s
쌧s	쌧s
쌧ɓߎs	쌧ɓߎs
쌧s	쌧s
쌧s	쌧s
쌧咬s	쌧咬s
쌧юRs	쌧юRs
쌧s	쌧s
쌧Ks	쌧Ks
쌧vs	쌧vs
쌧Ȏs	쌧Ȏs
쌧s	쌧s
쌧ܖs	쌧ܖs
sS̏o	sS̏o
sSw	sSw
sS䒬	sS䒬
sS	sS
s哇x哇	s哇x哇
s哇x	s哇x
s哇xV	s哇xV
s哇x_Ó	s哇x_Ó
sOxO	sOxO
sOx䑠	sOx䑠
sx䒬	sx䒬
sx	sx
s}x}	s}x}
sc	sc
s	s
s`	s`
sVh	sVh
s	s
s䓌	s䓌
snc	snc
s]	s]
si	si
sڍ	sڍ
sc	sc
scJ	scJ
saJ	saJ
s	s
s	s
sL	sL
sk	sk
sr	sr
s	s
sn	sn
s	s
s	s
s]ː	s]ː
sqs	sqs
ss	ss
ss	ss
sOs	sOs
s~s	s~s
s{s	s{s
ss	ss
szs	szs
scs	scs
ss	ss
ss	ss
ss	ss
sRs	sRs
ss	ss
ss	ss
ss	ss
s]s	s]s
sas	sas
ss	ss
svĎs	svĎs
sRs	sRs
ss	ss
ss	ss
sHs	sHs
ss	ss
ss	ss
sc	sc
s	s
s`	s`
sVh	sVh
s	s
s䓌	s䓌
snc	snc
s]	s]
si	si
sڍ	sڍ
sc	sc
scJ	scJ
saJ	saJ
s	s
s	s
sL	sL
sk	sk
sr	sr
s	s
sn	sn
s	s
s	s
s]ː	s]ː
_ސ쌧bS쒬	_ސ쌧bS쒬
_ސ쌧bS쑺	_ސ쌧bS쑺
_ސ쌧S䒬	_ސ쌧S䒬
_ސ쌧SJ	_ސ쌧SJ
_ސ쌧S䒬	_ސ쌧S䒬
_ސ쌧Sc	_ސ쌧Sc
_ސ쌧SRk	_ސ쌧SRk
_ސ쌧S^ߒ	_ސ쌧S^ߒ
_ސ쌧S͌	_ސ쌧S͌
_ސ쌧S	_ސ쌧S
_ސ쌧S쒬	_ސ쌧S쒬
_ސ쌧S{	_ސ쌧S{
_ސ쌧S钬	_ސ쌧S钬
_ސ쌧OYStR	_ސ쌧OYStR
_ސ쌧ls	_ސ쌧ls
lsߌ	lsߌ
ls_ސ	ls_ސ
ls	ls
ls	ls
ls	ls
lsۓyJ	lsۓyJ
lsq	lsq
ls	ls
ls`k	ls`k
ls˒ˋ	ls˒ˋ
ls`	ls`
ls	ls
ls΋	ls΋
lsJ	lsJ
lsh	lsh
ls	ls
lst	lst
lss}	lss}
_ސ쌧{s	_ސ쌧{s
_ސ쌧s	_ސ쌧s
s	s
sK	sK
s	s
sË	sË
s	s
s{O	s{O
s	s
_ސ쌧ˎs	_ސ쌧ˎs
_ސ쌧qs	_ސ쌧qs
_ސ쌧s	_ސ쌧s
_ސ쌧cs	_ސ쌧cs
_ސ쌧s	_ސ쌧s
_ސ쌧qs	_ސ쌧qs
_ސ쌧͌s	_ސ쌧͌s
͌s΋	͌s΋
͌s	͌s
͌s	͌s
_ސ쌧OYs	_ސ쌧OYs
_ސ쌧`s	_ސ쌧`s
_ސ쌧؎s	_ސ쌧؎s
_ސ쌧as	_ސ쌧as
_ސ쌧ɐs	_ސ쌧ɐs
_ސ쌧CVs	_ސ쌧CVs
_ސ쌧Ԏs	_ސ쌧Ԏs
_ސ쌧쑫s	_ސ쌧쑫s
_ސ쌧s	_ސ쌧s
t[S쒬	t[S쒬
t΋Sh	t΋Sh
t΋S命쒬	t΋S命쒬
t׌Sh	t׌Sh
t׌SX䒬	t׌SX䒬
tS_蒬	tS_蒬
tS	tS
tSÒ	tSÒ
tRS\㗢	tRS\㗢
tRSŎR	tRSŎR
tRSŌ	tRSŌ
tts	tts
ts	ts
tsԌ	tsԌ
tsы	tsы
tst	tst
ts΋	ts΋
tsl	tsl
tS{	tS{
tSq	tSq
tS	tS
tS쒬	tS쒬
tS	tS
tSr	tSr
tqs	tqs
tss	tss
tDs	tDs
tَRs	tَRs
t؍XÎs	t؍XÎs
tˎs	tˎs
tcs	tcs
tΌs	tΌs
tcs	tcs
tqs	tqs
ts	ts
ts	ts
tKus	tKus
ts	ts
tYs	tYs
tss	tss
tRs	tRs
ts	ts
t䑷qs	t䑷qs
ts	ts
tNÎs	tNÎs
tJs	tJs
txÎs	txÎs
tYs	tYs
tlXs	tlXs
tYs	tYs
tXs	tXs
t󐼎s	t󐼎s
ts	ts
txs	txs
t[s	t[s
txs	txs
ts	ts
tRs	tRs
tݎs	tݎs
tԔs	tԔs
ʌԌSz	ʌԌSz
ʌԌSOF	ʌԌSOF
ʌԌSјCR	ʌԌSјCR
ʌ嗢S񋏒	ʌ嗢S񋏒
ʌkSɓޒ	ʌkSɓޒ
ʌkS˒	ʌkS˒
ʌkS	ʌkS
ʌʌS㗢	ʌʌS㗢
ʌʌS	ʌʌS
ʌʌS_쒬	ʌʌS_쒬
ʌS쒬	ʌS쒬
ʌSҒ	ʌSҒ
ʌS	ʌS
ʌS	ʌS
ʌSF쒬	ʌSF쒬
ʌS쒬	ʌS쒬
ʌS쓇	ʌS쓇
ʌS쒬	ʌS쒬
ʌSR	ʌSR
ʌSg	ʌSg
ʌSR	ʌSR
ʌSƂ풬	ʌSƂ풬
ʌʌS{㒬	ʌʌS{㒬
ʌzs	ʌzs
ʌFJs	ʌFJs
ʌs	ʌs
ʌscs	ʌscs
ʌs	ʌs
ʌs	ʌs
ʌє\s	ʌє\s
ʌ{s	ʌ{s
ʌ{s	ʌ{s
ʌRs	ʌRs
ʌts	ʌts
ʌRs	ʌRs
ʌHs	ʌHs
ʌs	ʌs
ʌ[Js	ʌ[Js
ʌs	ʌs
ʌs	ʌs
ʌzJs	ʌzJs
ʌns	ʌns
ʌ˓cs	ʌ˓cs
ʌԎs	ʌԎs
ʌs	ʌs
ʌu؎s	ʌu؎s
ʌas	ʌas
ʌVs	ʌVs
ʌs	ʌs
ʌvs	ʌvs
ʌk{s	ʌk{s
ʌs	ʌs
ʌxms	ʌxms
ʌOs	ʌOs
ʌ@cs	ʌ@cs
ʌˎs	ʌˎs
ʌKs	ʌKs
ʌ߃s	ʌ߃s
ʌs	ʌs
ʌgs	ʌgs
ʌ܎s	ʌ܎s
܎s	܎s
܎sk	܎sk
܎s{	܎s{
܎s	܎s
܎s	܎s
܎s	܎s
܎sYa	܎sYa
܎s	܎s
܎s΋	܎s΋
܎s΋	܎s΋
ʌӂݖs	ʌӂݖs
ʌs	ʌs
錧~S	錧~S
錧~S͓	錧~S͓
錧~SY	錧~SY
錧knS	錧knS
錧vSq	錧vSq
錧S܉	錧S܉
錧S	錧S
錧߉όSC	錧߉όSC
錧ˎs	錧ˎs
錧S钬	錧S钬
錧S	錧S
錧S闢	錧S闢
錧S㒬	錧S㒬
錧s	錧s
錧yYs	錧yYs
錧É͎s	錧É͎s
錧Ήs	錧Ήs
錧s	錧s
錧s	錧s
錧Ȏs	錧Ȏs
錧헤cs	錧헤cs
錧s	錧s
錧ks	錧ks
錧}Ԏs	錧}Ԏs
錧s	錧s
錧vs	錧vs
錧Ύs	錧Ύs
錧ЂȂs	錧ЂȂs
錧s	錧s
錧s	錧s
錧Js	錧Js
錧헤{s	錧헤{s
錧߉ώs	錧߉ώs
錧}s	錧}s
錧Ⓦs	錧Ⓦs
錧~s	錧~s
錧݂s	錧݂s
錧s	錧s
錧_s	錧_s
錧ss	錧ss
錧gcs	錧gcs
錧푍s	錧푍s
錧΂݂炢s	錧΂݂炢s
錧ʎs	錧ʎs
Ȗ،͓SO쒬	Ȗ،͓SO쒬
Ȗ،JS	Ȗ،JS
Ȗ،JSJ	Ȗ،JSJ
Ȗ،sSؒ	Ȗ،sSؒ
Ȗ،sSp	Ȗ،sSp
Ȗ،sSM	Ȗ،sSM
Ȗ،ߐ{Sߐ{	Ȗ،ߐ{Sߐ{
Ȗ،ߐ{S߉ϐ쒬	Ȗ،ߐ{S߉ϐ쒬
Ȗ،FSsL	Ȗ،FSsL
Ȗ،FSF꒬	Ȗ،FSF꒬
Ȗ،FSvq	Ȗ،FSvq
Ȗ،FSΖؒ	Ȗ،FSΖؒ
Ȗ،Fs{s	Ȗ،Fs{s
Ȗ،s	Ȗ،s
Ȗ،Ȗ؎s	Ȗ،Ȗ؎s
Ȗ،s	Ȗ،s
Ȗ،s	Ȗ،s
Ȗ،s	Ȗ،s
Ȗ،Rs	Ȗ،Rs
Ȗ،^s	Ȗ،^s
Ȗ،cs	Ȗ،cs
Ȗ،s	Ȗ،s
Ȗ،ߐ{s	Ȗ،ߐ{s
Ȗ،s	Ȗ،s
Ȗ،ߐ{GRs	Ȗ،ߐ{GRs
Ȗ،s	Ȗ،s
QnȌSÒ	QnȌSÒ
QnȌSR	QnȌSR
QnȌSڗ	QnȌSڗ
QnȌS쌴	QnȌS쌴
QnȌSV	QnȌSV
QnȌSȒ	QnȌSȒ
QnWySq	QnWySq
QnWySWy	QnWySWy
QnWyS	QnWyS
QnWySa	QnWySa
QnWySc	QnWySc
QnÊySÊy	QnÊySÊy
QnÊySmc	QnÊySmc
QnÊySq	QnÊySq
QnkQnSg	QnkQnSg
QnkQnSY	QnkQnSY
QngSʑ	QngSʑ
QnS쑺	QnS쑺
QnS_	QnS_
QnOs	QnOs
QnSЕi	QnSЕi
QnSꑺ	QnSꑺ
QnSa	QnSa
QnS݂Ȃݒ	QnS݂Ȃݒ
Qns	Qns
Qnːs	Qnːs
Qnɐs	Qnɐs
Qncs	Qncs
Qncs	Qncs
Qnٗюs	Qnٗюs
Qnas	Qnas
Qns	Qns
Qnxs	Qnxs
Qns	Qns
Qn݂ǂs	Qn݂ǂs
RksS	RksS
RksSOgR	RksSOgR
RSa	RSa
RSsO	RSsO
R싐S암	R싐S암
R싐S쒬	R싐S쒬
R싐Sg	R싐Sg
R싐Sxm쒬	R싐Sxm쒬
RsSE쑺	RsSE쑺
RsSu	RsSu
RsS	RsS
RsSj	RsSj
RsSRΑ	RsSRΑ
RsSxm͌Β	RsSxm͌Β
Rb{s	Rb{s
Rxmgcs	Rxmgcs
Rss	Rss
RRs	RRs
R匎s	R匎s
RBs	RBs
RAvXs	RAvXs
Rkms	Rkms
Rbs	Rbs
RJs	RJs
R쌴s	R쌴s
RbBs	RbBs
Rs	Rs
ÉΌSɓ	ÉΌSɓ
ÉΌS蒬	ÉΌS蒬
ÉΌS͒Ò	ÉΌS͒Ò
ÉΌSɓ	ÉΌSɓ
ÉΌSɓ	ÉΌSɓ
ÉqSX	ÉqSX
ÉxS	ÉxS
ÉxS	ÉxS
ÉxSR	ÉxSR
ÉÉs	ÉÉs
És	És
Ésx͋	Ésx͋
És	És
ÉcS쒬	ÉcS쒬
ÉYSgc	ÉYSgc
ÉYS썪{	ÉYS썪{
Éls	Éls
lsV	lsV
ls	ls
lsl	lsl
ÉÎs	ÉÎs
ÉMCs	ÉMCs
ÉOs	ÉOs
Éxm{s	Éxm{s
Éɓs	Éɓs
Écs	Écs
É֓cs	É֓cs
ÉĒÎs	ÉĒÎs
Éxms	Éxms
É|s	É|s
É}s	É}s
Éas	Éas
É܈s	É܈s
Écs	Écs
És	És
Éΐs	Éΐs
Éɓs	Éɓs
ÉOs	ÉOs
Ées	Ées
Éɓ̍s	Éɓ̍s
ÉqVs	ÉqVs
򕌌S	򕌌S
򕌌S_˒	򕌌S_˒
򕌌S֔V	򕌌S֔V
򕌌KSrc	򕌌KSrc
򕌌KSK쒬	򕌌KSK쒬
򕌌KS쒬	򕌌KS쒬
򕌌S쑺	򕌌S쑺
򕌌S䐓	򕌌S䐓
򕌌ΌSӒ	򕌌ΌSӒ
򕌌ΌSj	򕌌ΌSj
򕌌ΌSx	򕌌ΌSx
򕌌ΌS쑺	򕌌ΌS쑺
򕌌ΌS쒬	򕌌ΌS쒬
򕌌ΌS@	򕌌ΌS@
򕌌ΌSSÒ	򕌌ΌSSÒ
򕌌򕌎s	򕌌򕌎s
򕌌HS}	򕌌HS}
򕌌HS쒬	򕌌HS쒬
򕌌sjSփP	򕌌sjSփP
򕌌sjS䒬	򕌌sjS䒬
򕌌{Sk	򕌌{Sk
򕌌{VS{V	򕌌{VS{V
򕌌_s	򕌌_s
򕌌Rs	򕌌Rs
򕌌s	򕌌s
򕌌֎s	򕌌֎s
򕌌Ðs	򕌌Ðs
򕌌Zs	򕌌Zs
򕌌Qs	򕌌Qs
򕌌Hs	򕌌Hs
򕌌bߎs	򕌌bߎs
򕌌ZΎs	򕌌ZΎs
򕌌ys	򕌌ys
򕌌es	򕌌es
򕌌s	򕌌s
򕌌Rs	򕌌Rs
򕌌s	򕌌s
򕌌ˎs	򕌌ˎs
򕌌{s	򕌌{s
򕌌Ss	򕌌Ss
򕌌Cs	򕌌Cs
򕌌CÎs	򕌌CÎs
mmS	mmS
mCS厡	mCS厡
mCSI]	mCSI]
mCS򓇑	mCS򓇑
mk݊ySL	mk݊ySL
mk݊yS݊y	mk݊yS݊y
mk݊ySh	mk݊ySh
mmSv䒬	mmSv䒬
mmSL	mmSL
mmSY	mmSY
mmSm	mmSm
mmSl	mmSl
mtSLR	mtSLR
mOHS	mOHS
mOHS}K	mOHS}K
mÉs	mÉs
És	És
És	És
Ésk	Ésk
És	És
És	És
És	És
Ésa	Ésa
És	És
ÉsMc	ÉsMc
mzcSKc	mzcSKc
És	És
És`	És`
És	És
ÉsR	ÉsR
És΋	És΋
És	És
ÉsV	ÉsV
mLs	mLs
ms	ms
m{s	m{s
mˎs	mˎs
mcs	mcs
mts	mts
mLs	mLs
mÓs	mÓs
mɓs	mɓs
mJs	mJs
mLcs	mLcs
ms	ms
ms	ms
mSs	mSs
mRs	mRs
m튊s	m튊s
m]s	m]s
mqs	mqs
ms	ms
mVs	mVs
mCs	mCs
m{s	m{s
mms	mms
mls	mls
mms	mms
ms	ms
mqs	mqs
mLs	mLs
mis	mis
mcs	mcs
ms	ms
m{s	m{s
mkÉs	mkÉs
mxs	mxs
m݂悵s	m݂悵s
m܎s	m܎s
mvs	mvs
OdٌS	OdٌS
OdkKSIk	OdkKSIk
OdKSؑ]	OdKSؑ]
OdÎs	OdÎs
OdCSC	OdCSC
OdCS䒬	OdCS䒬
OdCSa	OdCSa
OdOdS	OdOdS
OdOdSz	OdOdSz
OdOdSԖ쒬	OdOdSԖ쒬
Od어KSI	Od어KSI
Od어KSl	Od어KSl
OdxSʏ钬	OdxSʏ钬
OdxSx	OdxSx
OdxSI	OdxSI
OdxSɐ	OdxSɐ
Odlss	Odlss
Odɐs	Odɐs
Ods	Ods
OdKs	OdKs
Od鎭s	Od鎭s
Ods	Ods
Odhs	Odhs
OdTRs	OdTRs
OdHs	OdHs
OdFs	OdFs
OdȂ׎s	OdȂ׎s
Odus	Odus
Odɉs	Odɉs
s{PSR蒬	s{PSR蒬
s{vSvR	s{vSvR
s{yS}u	s{yS}u
s{ySؒ	s{ySؒ
s{ySR鑺	s{ySR鑺
s{ySa	s{ySa
s{ss	s{ss
ssk	ssk
ss㋞	ss㋞
ss	ss
ss	ss
ssR	ssR
ss	ss
ss	ss
ssE	ssE
ss	ss
s{ԊS蒬	s{ԊS蒬
s{ԊSFc	s{ԊSFc
ssRȋ	ssRȋ
ss	ss
s{DSOg	s{DSOg
s{^ӌSɍ	s{^ӌSɍ
s{^ӌS^Ӗ쒬	s{^ӌS^Ӗ쒬
s{mRs	s{mRs
s{ߎs	s{ߎs
s{s	s{s
s{Fs	s{Fs
s{{Îs	s{{Îs
s{Ts	s{Ts
s{zs	s{zs
s{s	s{s
s{s	s{s
s{s	s{s
s{cӎs	s{cӎs
s{Os	s{Os
s{Os	s{Os
s{ؒÐs	s{ؒÐs
ꌧSbǒ	ꌧSbǒ
ꌧSL	ꌧSL
ꌧS꒬	ꌧS꒬
ꌧmS	ꌧmS
ꌧS쒬	ꌧS쒬
ꌧS	ꌧS
ꌧÎs	ꌧÎs
ꌧFs	ꌧFs
ꌧls	ꌧls
ꌧߍ]s	ꌧߍ]s
ꌧÎs	ꌧÎs
ꌧRs	ꌧRs
ꌧIs	ꌧIs
ꌧbs	ꌧbs
ꌧFs	ꌧFs
ꌧΓs	ꌧΓs
ꌧs	ꌧs
ꌧߍ]s	ꌧߍ]s
ꌧČs	ꌧČs
ޗǌSg	ޗǌSg
ޗǌS	ޗǌS
ޗǌSO	ޗǌSO
ޗǌSQ	ޗǌSQ
ޗǌFɌS]	ޗǌFɌS]
ޗǌFɌS	ޗǌFɌS
ޗǌkS	ޗǌkS
ޗǌkSq	ޗǌkSq
ޗǌkS͍	ޗǌkS͍
ޗǌkSL˒	ޗǌkSL˒
ޗǌS쐼	ޗǌS쐼
ޗǌSc{	ޗǌSc{
ޗǌSO	ޗǌSO
ޗǌsS	ޗǌsS
ޗǌsS撬	ޗǌsS撬
ޗǌRӌSRY	ޗǌRӌSRY
ޗǌޗǎs	ޗǌޗǎs
ޗǌgSkR	ޗǌgSkR
ޗǌgSꑺ	ޗǌgSꑺ
ޗǌgSkR	ޗǌgSkR
ޗǌgS嗄	ޗǌgS嗄
ޗǌgS㑺	ޗǌgS㑺
ޗǌgSs	ޗǌgSs
ޗǌgSV쑺	ޗǌgSV쑺
ޗǌgS\Ð쑺	ޗǌgS\Ð쑺
ޗǌgS씗쑺	ޗǌgS씗쑺
ޗǌgSg쑺	ޗǌgSg쑺
ޗǌgSg쒬	ޗǌgSg쒬
ޗǌacs	ޗǌacs
ޗǌaSRs	ޗǌaSRs
ޗǌVs	ޗǌVs
ޗǌs	ޗǌs
ޗǌs	ޗǌs
ޗǌܞs	ޗǌܞs
ޗǌ䏊s	ޗǌ䏊s
ޗǌs	ޗǌs
ޗǌŎs	ޗǌŎs
ޗǌs	ޗǌs
ޗǌFɎs	ޗǌFɎs
{SF撬	{SF撬
{ScK	{ScK
{S	{S
{kS	{kS
{L\SL\	{L\SL\
{L\S\	{L\S\
{OS{	{OS{
{͓S͓쒬	{͓S͓쒬
{͓Sq	{͓Sq
{͓S瑁ԍ㑺	{͓S瑁ԍ㑺
{s	{s
sk	sk
ss	ss
s	s
sԋ	sԋ
s	s
s`	s`
s吳	s吳
sV	sV
sQ	sQ
s	s
s	s
s	s
s	s
s	s
s铌	s铌
s{	s{
sZg	sZg
sZg	sZg
s	s
s	s
sߌ	sߌ
sZV]	sZV]
s	s
s	s
{s	{s
s	s
s	s
s	s
s	s
s	s
sk	sk
s	s
{ݘacs	{ݘacs
{Ls	{Ls
{rcs	{rcs
{cs	{cs
{Îs	{Îs
{Ύs	{Ύs
{Lˎs	{Lˎs
{s	{s
{s	{s
{؎s	{؎s
{s	{s
{򍲖s	{򍲖s
{xcюs	{xcюs
{Qs	{Qs
{͓s	{͓s
{s	{s
{哌s	{哌s
{as	{as
{ʎs	{ʎs
{s	{s
{Hgs	{Hgs
{^s	{^s
{ےÎs	{ےÎs
{䎛s	{䎛s
{Ύs	{Ύs
{s	{s
{s	{s
{ls	{ls
{s	{s
{㋷Rs	{㋷Rs
{s	{s
a̎RLcSL쒬	a̎RLcSL쒬
a̎RLcS	a̎RLcS
a̎RLcSLc쒬	a̎RLcSLc쒬
a̎RɓsSxR	a̎RɓsSxR
a̎RɓsS炬	a̎RɓsS炬
a̎RɓsS쒬	a̎RɓsS쒬
a̎RCSI쒬	a̎RCSI쒬
a̎RKSxc	a̎RKSxc
a̎RKSl	a̎RKSl
a̎RKSݒ	a̎RKSݒ
a̎RKSkR	a̎RKSkR
a̎RKSÍ쒬	a̎RKSÍ쒬
a̎RKSn	a̎RKSn
a̎RKSߒqY	a̎RKSߒqY
a̎RKS{	a̎RKS{
a̎RSRǒ	a̎RSRǒ
a̎RS쒬	a̎RS쒬
a̎RS	a̎RS
a̎RSl	a̎RSl
a̎RS݂Ȃג	a̎RS݂Ȃג
a̎RS쒬	a̎RS쒬
a̎Ra̎Rs	a̎Ra̎Rs
a̎RV{s	a̎RV{s
a̎RCs	a̎RCs
a̎Rcӎs	a̎Rcӎs
a̎RVs	a̎RVs
a̎R{s	a̎R{s
a̎RLcs	a̎RLcs
a̎RI̐s	a̎RI̐s
a̎Ros	a̎Ros
ɌԕSS	ɌԕSS
ɌKیSq	ɌKیSq
ɌÌS	ɌÌS
ɌÌSd	ɌÌSd
Ɍ_ˎs	Ɍ_ˎs
_ˎs	_ˎs
_ˎs	_ˎs
_ˎsɋ	_ˎsɋ
_ˎsc	_ˎsc
_ˎs{	_ˎs{
_ˎs	_ˎs
_ˎsk	_ˎsk
_ˎs	_ˎs
_ˎs	_ˎs
ɌӌS쒬	ɌӌS쒬
Ɍ_Ss쒬	Ɍ_Ss쒬
Ɍ_S蒬	Ɍ_S蒬
Ɍ_S_͒	Ɍ_S_͒
ɌpSp	ɌpSp
ɌS	ɌS
ɌPHs	ɌPHs
ɌS	ɌS
ɌSV	ɌSV
Ɍs	Ɍs
ɌΎs	ɌΎs
Ɍ{s	Ɍ{s
ɌF{s	ɌF{s
Ɍs	Ɍs
ɌɒOs	ɌɒOs
Ɍs	Ɍs
ɌLs	ɌLs
ɌÐs	ɌÐs
Ɍԕs	Ɍԕs
Ɍes	Ɍes
Ɍˎs	Ɍˎs
ɌO؎s	ɌO؎s
Ɍs	Ɍs
Ɍ쐼s	Ɍ쐼s
Ɍs	Ɍs
ɌOcs	ɌOcs
Ɍs	Ɍs
ɌOgRs	ɌOgRs
Ɍ{s	Ɍ{s
ɌOgs	ɌOgs
Ɍ삠킶s	Ɍ삠킶s
Ɍs	Ɍs
ɌWHs	ɌWHs
Ɍs	Ɍs
Ɍs	Ɍs
Ɍ̎s	Ɍ̎s
xRVS	xRVS
xRVSP	xRVSP
xRVSM	xRVSM
xRVSs	xRVSs
xRVSR	xRVSR
xRxRs	xRxRs
xRs	xRs
xRÎs	xRÎs
xRXs	xRXs
xRs	xRs
xRs	xRs
xRvgs	xRvgs
xRs	xRs
xRvs	xRvs
xRːs	xRːs
䌧Src	䌧Src
䌧ьSl	䌧ьSl
䌧ьS	䌧ьS
䌧SzO	䌧SzO
䌧OSzO	䌧OSzO
䌧s	䌧s
䌧OSl	䌧OSl
䌧gcSi	䌧gcSi
䌧O㒆Sዷ	䌧O㒆Sዷ
䌧։s	䌧։s
䌧ls	䌧ls
䌧s	䌧s
䌧Rs	䌧Rs
䌧I]s	䌧I]s
䌧s	䌧s
䌧zOs	䌧zOs
䌧s	䌧s
ΐ쌧S\o	ΐ쌧S\o
ΐ쌧͖kS咬	ΐ쌧͖kS咬
ΐ쌧͖kSÔ	ΐ쌧͖kSÔ
ΐ쌧\Sk	ΐ쌧\Sk
ΐ쌧HSu꒬	ΐ쌧HSu꒬
ΐ쌧HSBu	ΐ쌧HSBu
ΐ쌧PS	ΐ쌧PS
ΐ쌧PS\o	ΐ쌧PS\o
ΐ쌧s	ΐ쌧s
ΐ쌧s	ΐ쌧s
ΐ쌧s	ΐ쌧s
ΐ쌧֓s	ΐ쌧֓s
ΐ쌧Fs	ΐ쌧Fs
ΐ쌧s	ΐ쌧s
ΐ쌧Hs	ΐ쌧Hs
ΐ쌧قs	ΐ쌧قs
ΐ쌧Rs	ΐ쌧Rs
ΐ쌧\s	ΐ쌧\s
ΐ쌧Xss	ΐ쌧Xss
RpcSq	RpcSq
RS	RS
RcS|	RcS|
RcSދ`	RcSދ`
RcS	RcS
RRs	RRs
Rsk	Rsk
Rs	Rs
Rs	Rs
Rs	Rs
RvČSvē쒬	RvČSvē쒬
RvČS璬	RvČS璬
RsES	RsES
RϓcS쒬	RϓcS쒬
R^SV	R^SV
RaCSaC	RaCSaC
Rq~s	Rq~s
RSg	RSg
RÎRs	RÎRs
Rʖs	Rʖs
R}s	R}s
R䌴s	R䌴s
RЎs	RЎs
Rs	Rs
RVs	RVs
ROs	ROs
R˓s	R˓s
RԔ֎s	RԔ֎s
R^s	R^s
Rs	Rs
Rs	Rs
ѐΌSѓ쒬	ѐΌSѓ쒬
WqS{	WqS{
WqS	WqS
WqSW쒬	WqSW쒬
BSmv	BSmv
BSCm	BSCm
BSm	BSm
BSB̓	BSB̓
SØa쒬	SØa쒬
Sg꒬	Sg꒬
]s	]s
mSo_	mSo_
lcs	lcs
o_s	o_s
vcs	vcs
cs	cs
s	s
]Îs	]Îs
_s	_s
RS	RS
R哇Sh哇	R哇Sh哇
RόSaؒ	RόSaؒ
RFьS֒	RFьS֒
RFьScz{	RFьScz{
RFьS	RFьS
RRs	RRs
R֎s	R֎s
RFs	RFs
Rs	Rs
Rh{s	Rh{s
Rs	Rs
R⍑s	R⍑s
Rs	Rs
Rs	Rs
Rs	Rs
RIs	RIs
Rs	Rs
RRzcs	RRzcs
挧S	挧S
挧SgÑ	挧SgÑ
挧SR	挧SR
挧S암	挧S암
挧S˒	挧S˒
挧SO	挧SO
挧Sl	挧Sl
挧SՉY	挧SՉY
挧Skh	挧Skh
挧S]{	挧S]{
挧S쒬	挧S쒬
挧S쒬	挧S쒬
挧S	挧S
挧Sq	挧Sq
挧S	挧S
挧s	挧s
挧qgs	挧qgs
挧Ďqs	挧Ďqs
挧`s	挧`s
L|SCc	L|SCc
L|SF쒬	L|SF쒬
L|S⒬	L|S⒬
L|S{	L|S{
L_ΌS_΍	L_ΌS_΍
LS	LS
LLs	LLs
Ls	Ls
Ls	Ls
Ls	Ls
Ls	Ls
Ls	Ls
Lsk	Lsk
Ls|	Ls|
Ls	Ls
LLcS㓇	LLcS㓇
LRS|c	LRS|c
LRSkL	LRSkL
Ls	Ls
L|s	L|s
LOs	LOs
Ls	Ls
LRs	LRs
L{s	L{s
LOs	LOs
Ls	Ls
L|s	L|s
LLs	LLs
Lss	Lss
L|cs	L|cs
L]cs	L]cs
쌧̌SFÒ	쌧̌SFÒ
쌧̌S쒬	쌧̌S쒬
쌧S	쌧S
쌧ؓcSOؒ	쌧ؓcSOؒ
쌧Sy	쌧Sy
쌧S	쌧S
쌧xSՕ	쌧xSՕ
쌧xSxÒ	쌧xSxÒ
쌧xS܂̂	쌧xS܂̂
쌧s	쌧s
쌧ۋTs	쌧ۋTs
쌧os	쌧os
쌧Pʎs	쌧Pʎs
쌧ωs	쌧ωs
쌧ʂs	쌧ʂs
쌧s	쌧s
쌧OLs	쌧OLs
SZ	SZ
S쒬	S쒬
S	S
Sk	Sk
SΒ	SΒ
CS	CS
CSg	CSg
CSCz	CSCz
YSY	YSY
YS㏟	YS㏟
߉S߉꒬	߉S߉꒬
SΈ䒬	SΈ䒬
S_R	S_R
S߉͓	S߉͓
nS邬	nS邬
s	s
ODS݂悵	ODS݂悵
s	s
s	s
s	s
gs	gs
gs	gs
ns	ns
ODs	ODs
Qɗ\SO	Qɗ\SO
Qɗ\Su	Qɗ\Su
QzqS㓇	QzqS㓇
Q㕂Sv	Q㕂Sv
Q쑽Sq	Q쑽Sq
QkFaS쒬	QkFaS쒬
QkFaSSk	QkFaSSk
QRs	QRs
QFaSɕ	QFaSɕ
QFaS쒬	QFaS쒬
Qs	Qs
QFas	QFas
Qls	Qls
QVls	QVls
Qs	Qs
QFs	QFs
Qɗ\s	Qɗ\s
Qls	Qls
Q\s	Q\s
Qs	Qs
mS̒	mS̒
mSm쒬	mSm쒬
m|SnH	m|SnH
m|Sc쒬	m|Sc쒬
m|Sޔ	m|Sޔ
m|Sc	m|Sc
m|Sk쑺	m|Sk쑺
m|S|	m|S|
m|Sm	m|Sm
mS쒬	mS쒬
mSzm	mSzm
mSy	mSy
mS	mS
mS	mS
mSÖ쒬	mSÖ쒬
mSl\	mSl\
myS쑺	myS쑺
mySy	mySy
mSL	mSL
mS{R	mS{R
mSO	mSO
mS匎	mS匎
mS	mS
mms	mms
mˎs	mˎs
m|s	m|s
mys	mys
m{s	m{s
mhюs	mhюs
mys	mys
m썑s	m썑s
ml\s	ml\s
ms	ms
ms	ms
qS}O	qS}O
qS	qS
S	S
S_	S_
S꒬	S꒬
S	S
SF	SF
S	S
SI	SI
Suƒ	Suƒ
SV{	SV{
SvR	SvR
S{b	S{b
ÕSj쒬	ÕSj쒬
ƎS|	ƎS|
ƎSƎ蒬	ƎSƎ蒬
cSԑ	cSԑ
cSc	cSc
cSC	cSC
cSt	cSt
cS蒬	cS蒬
cSYc	cSYc
cSq	cSq
s	s
s	s
s	s
s	s
s	s
s	s
s	s
sǋ	sǋ
zSgx	zSgx
zSђ	zSђ
zSz㒬	zSz㒬
OS品	OS品
OSؒ	OSؒ
sSc	sSc
sS݂₱	sS݂₱
SL쒬	SL쒬
vĎs	vĎs
喴cs	喴cs
s	s
ђˎs	ђˎs
cs	cs
s	s
s	s
}s	}s
s	s
ss	ss
LOs	LOs
Ԏs	Ԏs
kBs	kBs
kBsi	kBsi
kBsᏼ	kBsᏼ
kBs˔	kBs˔
kBsqk	kBsqk
kBsq	kBsq
kBs	kBs
kBs	kBs
Ss	Ss
ts	ts
}s	}s
s	s
@s	@s
ɕ{s	ɕ{s
És	És
Îs	Îs
͎s	͎s
{s	{s
Ös	Ös
qs	qs
݂܎s	݂܎s
s	s
߉ϐs	߉ϐs
ꌧ_Sg샖	ꌧ_Sg샖
ꌧnS咬	ꌧnS咬
ꌧnS]k	ꌧnS]k
ꌧnSΒ	ꌧnSΒ
ꌧYSLc	ꌧYSLc
ꌧYSC	ꌧYSC
ꌧÌSǒ	ꌧÌSǒ
ꌧO{S	ꌧO{S
ꌧO{SR	ꌧO{SR
ꌧO{S݂₫	ꌧO{S݂₫
ꌧs	ꌧs
ꌧÎs	ꌧÎs
ꌧs	ꌧs
ꌧvs	ꌧvs
ꌧɖs	ꌧɖs
ꌧYs	ꌧYs
ꌧs	ꌧs
ꌧs	ꌧs
ꌧs	ꌧs
ꌧ_s	ꌧ_s
茧kYSl꒬	茧kYSl꒬
茧kYSX	茧kYSX
茧ދnSÒ	茧ދnSÒ
茧ދnS^	茧ދnS^
茧ދnSI	茧ދnSI
茧ދnSg	茧ދnSg
茧ދnSދn	茧ދnSދn
茧쏼YSVܓ	茧쏼YSVܓ
茧s	茧s
茧ێs	茧ێs
茧s	茧s
茧|s	茧|s
茧呺s	茧呺s
茧ˎs	茧ˎs
茧Ys	茧Ys
茧Δns	茧Δns
茧s	茧s
茧ܓs	茧ܓs
茧Cs	茧Cs
茧_s	茧_s
茧쓇s	茧쓇s
F{kSÓޖؒ	F{kSÓޖؒ
F{kSk	F{kSk
F{hSYR	F{hSYR
F{hS	F{hS
F{hS쏬	F{hS쏬
F{hSX	F{hSX
F{hS	F{hS
F{hS숢h	F{hS숢h
F{VSk	F{VSk
F{vSÓ	F{vSÓ
F{vSb	F{vSb
F{vSv钬	F{vSv钬
F{vSD	F{vSD
F{vSRs	F{vSRs
F{erSez	F{erSez
F{erSÒ	F{erSÒ
F{Sܖؑ	F{Sܖؑ
F{Sǖؒ	F{Sǖؒ
F{Sђ	F{Sђ
F{S㑺	F{S㑺
F{SR]	F{SR]
F{SO	F{SO
F{S	F{S
F{SǑ	F{SǑ
F{S蒬	F{S蒬
F{vS	F{vS
F{F{s	F{F{s
F{s	F{s
F{s	F{s
F{s	F{s
F{s	F{s
F{sk	F{sk
F{ʖSʓ	F{ʖSʓ
F{ʖSF	F{ʖSF
F{ʖS֒	F{ʖS֒
F{ʖSa	F{ʖSa
F{SX쒬	F{SX쒬
F{s	F{s
F{lgs	F{lgs
F{rs	F{rs
F{s	F{s
F{ʖs	F{ʖs
F{Rs	F{Rs
F{ers	F{ers
F{Fys	F{Fys
F{Vs	F{Vs
F{Fs	F{Fs
F{hs	F{hs
F{Vs	F{Vs
F{us	F{us
啪S쒬	啪S쒬
啪Sd	啪Sd
啪So	啪So
啪啪s	啪啪s
啪SP	啪SP
啪ʕ{s	啪ʕ{s
啪Îs	啪Îs
啪cs	啪cs
啪s	啪s
啪Pns	啪Pns
啪Ëvs	啪Ëvs
啪|cs	啪|cs
啪L㍂cs	啪L㍂cs
啪nzs	啪nzs
啪Fs	啪Fs
啪Ls	啪Ls
啪Rzs	啪Rzs
啪s	啪s
{茧kSOҒ	{茧kSOҒ
{茧S쒬	{茧S쒬
{茧S璬	{茧S璬
{茧Ss_	{茧Ss_
{茧S؏钬	{茧S؏钬
{茧SVx	{茧SVx
{茧SėǑ	{茧SėǑ
{茧PnS܃	{茧PnS܃
{茧PnS䒬	{茧PnS䒬
{茧PnSVe	{茧PnSVe
{茧S	{茧S
{茧PnS쒬	{茧PnS쒬
{茧PnSŗt	{茧PnSŗt
{茧PnSˑ	{茧PnSˑ
{茧PnS	{茧PnS
{茧S	{茧S
{茧Sx	{茧Sx
{茧{s	{茧{s
{茧ss	{茧ss
{茧s	{茧s
{茧s	{茧s
{茧юs	{茧юs
{茧s	{茧s
{茧Ԏs	{茧Ԏs
{茧ss	{茧ss
{茧т̎s	{茧т̎s
ǌSN	ǌSN
oS	oS
哇Sm	哇Sm
哇S^_	哇S^_
哇Sa	哇Sa
哇SV钬	哇SV钬
哇Sɐ咬	哇Sɐ咬
哇SF	哇SF
哇SE	哇SE
哇S˓	哇S˓
哇S	哇S
哇SV	哇SV
哇Sa	哇Sa
SO	SO
S\	S\
̑Sǒ	̑Sǒ
̑Sэ]	̑Sэ]
̑S	̑S
̑S̕t	̑S̕t
FьSq	FьSq
FьSq	FьSq
FьSv	FьSv
s	s
FSܒ	FSܒ
]S蒬	]S蒬
s	s
s	s
vs	vs
os	os
whs	whs
V\s	V\s
s	s
Fs	Fs
us	us
]s	]s
s	s
ؖs	ؖs
삳܎s	삳܎s
uzus	uzus
s	s
Bs	Bs
ɍs	ɍs
ǎs	ǎs
ꌧSɍ]	ꌧSɍ]
ꌧSX	ꌧSX
ꌧS[	ꌧS[
ꌧSX	ꌧSX
ꌧS	ꌧS
ꌧSAm	ꌧSAm
ꌧS	ꌧS
ꌧS	ꌧS
ꌧS{	ꌧS{
ꌧKS	ꌧKS
ꌧKSɐ	ꌧKSɐ
ꌧKSɕ	ꌧKSɕ
ꌧKSk哌	ꌧKSk哌
ꌧKSnÕ~	ꌧKSnÕ~
ꌧKSn쑺	ꌧKSn쑺
ꌧKS앗	ꌧKS앗
ꌧKS哌	ꌧKS哌
ꌧKS^ߌ	ꌧKS^ߌ
ꌧKSԖ	ꌧKSԖ
ꌧKSvē	ꌧKSvē
ꌧKSd	ꌧKSd
ꌧSÎ[	ꌧSÎ[
ꌧSk鑺	ꌧSk鑺
ꌧSkJ	ꌧSkJ
ꌧS鑺	ꌧS鑺
ꌧS	ꌧS
ꌧSǒJ	ꌧSǒJ
ꌧ{ÌSǊԑ	ꌧ{ÌSǊԑ
ꌧdRS^ߍ	ꌧdRS^ߍ
ꌧdRS|x	ꌧdRS|x
ꌧߔes	ꌧߔes
ꌧΊ_s	ꌧΊ_s
ꌧXps	ꌧXps
ꌧs	ꌧs
ꌧYYs	ꌧYYs
ꌧs	ꌧs
ꌧs	ꌧs
ꌧLs	ꌧLs
ꌧ܎s	ꌧ܎s
ꌧ{Ós	ꌧ{Ós
ꌧs	ꌧs
end of file ynoso.dat
